8 8
# # # # # # # #
# # # . # # # #
# # # 0 # # # #
# # # $ 0 $ . #
# . 0 $ @ # # #
# # # # $ # # #
# # # # . # # #
# # # # # # # #
