9 9
# # # # # # # # #
# 0 0 0 # # # # #
# 0 $ @ # # # # #
# 0 $ $ # # # . #
# # # 0 # # # . #
# # # 0 0 0 0 . #
# # 0 0 0 # 0 0 #
# # 0 0 0 # # # #
# # # # # # # # #
